#######                    B
####### ########### ########
#####   ########        ####
##### #######      #########
#       ###    #############
#####  #### ####  #        #
###### #### #### ######### #
#       ### #######        #
####### ### ######## #######
#                          #
#                          #
#                          #
#############A###############